+-+-+-+-+-+-+-+-+-+
|. .|.|.|. .|. .|.|
+-+ +-+ + +-+-+-+ +
|.|. . . .|. .|.|.|
+-+-+ + + +-+-+ + +
|. . . . .|. . . .|
+ +-+ + + + + +-+ +
|.|.|.|.|. .|.|. .|
+ + + +-+-+-+-+-+-+
|. . . .|. .|. .|.|
+ +-+-+-+-+-+ + + +
|S # #|. .|.|.|. .|
+-+-+ + +-+-+-+ + +
|.|. #|.|. .|. .|.|
+-+-+ + +-+-+ +-+-+
|.|.|# # G|. . .|.|
+ + +-+-+-+ + + + +
|.|. . . .|. . . .|
+-+-+-+-+-+-+-+-+-+
